name: map1
tilewidth: 64
tileheight: 64
source: Courtyard.bmp 640 256
width: 24
height: 6
1 2 2 2 2 2 3 3 1 2 2 2 2 2 3 3 3 3 3 3 4 5 5 6 
7 8 7 7 7 7 2 2 7 8 7 7 7 7 2 2 2 2 9 9 10 11 12 13 
8 8 8 8 8 8 8 8 8 8 8 8 8 8 8 8 8 8 14 14 15 16 12 17 
18 19 14 18 18 14 18 14 18 18 14 18 18 14 18 14 14 14 19 20 21 22 23 24 
25 26 27 25 25 27 25 27 25 26 27 25 25 27 25 27 27 28 26 29 30 31 32 33 
20 20 20 20 20 20 20 20 20 20 20 20 20 20 20 20 20 20 20 20 20 20 20 20 