name: map2
tilewidth: 64
tileheight: 64
source: map2.bmp 640 704
width: 88
height: 6

5
0 0    1000
1 1001 2100
2 2101 3080
3 3081 4096
4 4097 5700

46
1 7 56   258 1 0
1 0 184  194 1 0
1 6 440  194 1 0
1 0 308  258 1 0
1 0 564  258 1 0
1 6 694  194 1 0 
1 0 882  258 1 0
1 0 950  194 1 0
1 0 1078 258 1 1
1 0 1206 194 1 1
1 8 1462 258 1 1
1 6 1334 66  1 1
1 3 1590 34  1 1
1 1 1718 66  1 1
1 0 1974 66  1 1
1 8 1846 258 1 1
1 0 2102 258 1 2
1 0 2230 258 1 2
1 0 2358 207 1 2
1 0 2484 258 1 2
1 0 2612 258 1 2 
1 0 2740 194 1 2
1 0 2860 66  1 2
1 1 3256 66  1 3
1 6 3384 66  1 3 
1 6 3512 194 1 3
1 8 3128 258 1 3
1 1 3672 66  1 3
1 6 3766 258 1 3
1 1 3896 36  1 3
1 9 4024 66  1 3
1 6 4280 66  1 4
1 0 4408 162 1 4
1 1 4152 194 1 4
1 0 4536 98  1 4
1 5 4790 194 1 4
1 0 4664 258 1 4
1 0 4918 258 1 4
1 1 5174 194 1 4
1 0 5302 258 1 4
1 6 5430 194 1 4
1 1 5558 194 1 4
1 9 2998 34  1 2 
2 7 2016 192 1 1
2 12 5472 256 1 4
3 13 3584 256 1 3


49
0 1 0    320  3072  32  3 0 1 2 
0 1 1376 192  96    32  1 1
0 1 1504 128  320   32  1 1
0 1 1856 192  160   32  1 1
0 1 2784 128  544   32  2 2 3
0 1 3328 192  96    32  1 3
0 1 3616 160  96    160 1 3
0 1 3648 320  1984  32  2 3 4
0 1 3776 192  96    32  1 3		
0 1 3904 128  416   32  2 3 4
0 1 4352 192  352   32  1 4
0 1 5440 256  32    32  1 4
0 1 5536 192  96    32  1 4
0 1 3712 160  64    32  1 3
0 1 3072 320  576   32  1 3
0 1 3056 0    32    32  2 2 3
0 1 4032 0    64    32  1 4
0 1 3056 160  32    160 2 2 3
0 1 4080 160  16    160 1 3
0 1 0    0    2     320	1 0
0 1 5616 0    16    320 1 4
0 1 3584 160  32    96  1 3


3 -1 1360 160 32 32 1 1
2  1 1232 288 32 32 1 1 
2  1 1424 160 32 32 1 1
3 -1 1488 96  32 32 1 1 
3  1 1808 96  32 32 1 1
2 -1 1872 160 32 32 1 1
2  1 2576 288 32 32 1 2
3 -1 2768 96  32 32 1 2
3  1 3408 160 32 32 1 3
2 -1 3536 288 32 32 1 3
3  1 3856 160 32 32 1 3
2 -1 3984 288 32 32 1 3
2 -1 4368 160 32 32 1 4
3  1 4304 96  32 32 1 4
3  1 4688 160 32 32 1 4
2 -1 4816 288 32 32 1 4
2  1 5456 224 32 32 1 4
3 -1 5520 160 32 32 1 4
3  1 3152 288 32 32 1 3
3  1 3792 288 32 32 1 3

5  1 3840 355 32 32 1 3
4  1 3200 355 32 32 1 3

8  1 0    150 5632 230 5 0 1 2 3 4
9  1 500  0   2000 380 3 0 1 2
10 1 3081 0   1050 380 1 3

12 1 4132 102 32 32 1 4
13 1 5534 281 32 32 1 4

2
0 3048 32 1 2
0 4072 32 1 3

4
0
3072
4096
5630

1 2 3 4 5 2 3 4 5 2 6 4 5 2 3 4 7 2 3 8 5 5 5 5 2 9 10 2 11 5 5 7 2 8 2 8 2 8 2 5 8 5 11 11 5 10 2 12 13 14 15 16 15 17 17 17 18 14 19 15 15 17 17 20 5 1 2 11 5 2 8 5 2 3 21 22 23 24 2 25 23 24 2 25 23 6 8 26 11 2 27 8 5 2 28 8 5 2 3 8 5 2 28 8 11 2 28 10 5 5 29 30 31 32 33 34 35 36 5 11 2 10 2 10 2 10 2 4 10 5 29 30 37 38 31 39 40 41 15 42 15 15 43 43 19 44 2 15 14 15 15 39 45 46 34 35 36 2 10 5 2 27 11 5 2 47 2 22 2 47 2 48 2 9 10 49 5 2 50 10 5 2 27 10 4 2 28 10 5 2 27 10 5 2 28 10 29 30 51 52 53 54 55 53 56 57 45 37 2 10 2 10 2 10 2 7 10 29 58 52 54 54 59 60 61 62 62 53 15 63 64 65 66 67 68 15 69 70 71 72 73 54 59 56 57 34 38 37 34 74 36 5 2 5 2 5 2 5 2 7 2 75 76 77 5 2 5 10 4 2 50 10 7 2 27 10 5 2 50 10 1 2 27 78 58 52 79 80 2 5 11 2 81 53 79 82 2 10 2 10 2 10 2 83 78 58 84 85 5 5 2 26 86 64 64 16 62 87 88 64 89 89 90 62 87 88 41 91 9 5 2 81 79 53 55 53 55 56 92 36 2 5 2 5 2 5 2 11 2 51 52 60 45 31 45 38 93 31 45 38 94 31 32 38 45 31 45 38 94 31 32 51 95 96 93 45 31 45 45 31 45 31 93 93 31 38 31 38 31 38 31 93 51 95 96 93 45 45 31 97 86 63 15 42 64 31 98 99 100 89 42 101 31 98 99 102 32 45 31 45 93 31 94 31 94 103 104 57 31 45 31 45 31 45 31 45 31 105 96 97 106 106 106 106 106 106 106 106 106 106 106 106 106 106 106 106 106 106 106 106 106 106 106 106 106 106 106 106 106 106 106 106 106 106 106 106 106 106 106 106 106 106 106 106 106 106 106 106 106 107 106 106 106 106 106 106 108 108 106 107 106 106 106 106 106 106 106 106 106 106 106 106 106 106 106 106 106 106 106 106 106 106 106 106 106 106 106 106 