name: map3
tilewidth: 64
tileheight: 64
source: Underground.bmp 640 256
width: 16
height: 6
2 
0 0 500
1 501 1024
9
1 8 56 66 1 0
1 0 184 66 1 0
1 0 311 66 1 0
1 8 440 66 1 0
1 0 568 66 1 1 
1 0 694 66 1 1
1 0 822 66 1 1
1 1 982 66 1 1	
2 7 928 160 1 1
 
13
0 1 192 96 64 32   1 0
0 1 0 160 448 32   1 0
0 1 512 160 64 32  1 1
0 1 640 160 288 32 1 1
0 1 964 224 64 32  1 1
0 1 896 288 64 32  1 1
0 1 0 0 4 160      1 0
0 1 1006 0 18 224  1 1
2 -1 176 64 32 32  1 0
2 -1 880 128 32 32 1 1
6 1 64 0 75 32     1 0
7 1 704 0 75 32    1 1
11 1 0 0 1024 384  2 0 1

0
2
0
1024

1 2 3 4 5 5 4 5 1 5 6 2 3 5 6 7 
8 9 2 10 5 5 11 5 6 5 6 9 2 3 6 7 
10 12 12 13 14 14 10 5 15 5 15 12 12 16 17 7 
4 18 18 4 19 20 1 21 1 21 1 20 22 18 1 23 
24 25 25 24 25 26 27 28 27 28 27 26 28 25 15 29 
30 30 30 30 30 30 30 30 30 30 30 30 30 30 31 30
